11111111111111111111111111111111111111111
1P000000000000000000000000000000000000001
10000000000000000000000000000000000000001
10000000000000000000000000000000000000001
101010101010101010101010100000C0001111111
10000000000000000000001011111111111111111
10000000000000000000001011111111111111111
10000000000000000000001011111111111111111
10000000000000000000001111111111111111111
11111111111111111111111111111111111111111
